FLWS	1-800 FLOWERS.COM	FLWS Profile	FLWS Analysis
XXII	22nd Century Group, Inc.	XXII Profile	XXII Analysis
DDD	3D SYSTEMS	DDD Profile	DDD Analysis
MMM	3M	MMM Profile	MMM Analysis
EGHT	8X 8 INC	EGHT Profile	EGHT Analysis
SHLM	A SCHULMAN	SHLM Profile	SHLM Analysis
AAON	AAON	AAON Profile	AAON Analysis
AIR	AAR	AIR Profile	AIR Analysis
AAN	AARON'S	AAN Profile	AAN Analysis
ABAX	ABAXIS	ABAX Profile	ABAX Analysis
ABT	ABBOTT LABORATORIES	ABT Profile	ABT Analysis
ABBV	ABBVIE INC	ABBV Profile	ABBV Analysis
ANF	ABERCROMBIE & FITCH	ANF Profile	ANF Analysis
ABMD	ABIOMED	ABMD Profile	ABMD Analysis
ABM	ABM INDUSTRIES	ABM Profile	ABM Analysis
AXAS	Abraxas Petroleum Corp.	AXAS Profile	AXAS Analysis
ACTG	ACACIA RESEARCH	ACTG Profile	ACTG Analysis
ACHC	ACADIA HEALTH CARE CO	ACHC Profile	ACHC Analysis
ACAD	ACADIA PHARMACEUTICALS	ACAD Profile	ACAD Analysis
AKR	ACADIA REALTY TRUST	AKR Profile	AKR Analysis
AXDX	Accelerate Diagnostics, Inc.	AXDX Profile	AXDX Analysis
XLRN	Acceleron Pharma, Inc.	XLRN Profile	XLRN Analysis
ACN	ACCENTURE	ACN Profile	ACN Analysis
ACCO	ACCO BRANDS	ACCO Profile	ACCO Analysis
ARAY	ACCURAY	ARAY Profile	ARAY Analysis
ACW	ACCURIDE	ACW Profile	ACW Analysis
ACE	ACE	ACE Profile	ACE Analysis
ACRX	ACELRX PHARMACEUTICALS	ACRX Profile	ACRX Analysis
ACET	ACETO	ACET Profile	ACET Analysis
AKAO	Achaogen, Inc.	AKAO Profile	AKAO Analysis
ACHN	ACHILLION PHARMACEUTICALS	ACHN Profile	ACHN Analysis
ACIW	ACI WORLDWIDE	ACIW Profile	ACIW Analysis
ACOR	ACORDA THERAPEUTICS	ACOR Profile	ACOR Analysis
ACT	Actavis plc	ACT Profile	ACT Analysis
ATVI	ACTIVISION BLIZZARD	ATVI Profile	ATVI Analysis
ATU	ACTUANT	ATU Profile	ATU Analysis
BIRT	ACTUATE	BIRT Profile	BIRT Analysis
AYI	ACUITY BRANDS	AYI Profile	AYI Analysis
ACXM	ACXIOM	ACXM Profile	ACXM Analysis
AE	ADAMS RESOURCES & ENERGY	AE Profile	AE Analysis
ADUS	ADDUS HOMECARE	ADUS Profile	ADUS Analysis
ADBE	ADOBE SYSTEMS	ADBE Profile	ADBE Analysis
ASC	ADSTAR	ASC Profile	ASC Analysis
ADT	ADT CORP	ADT Profile	ADT Analysis
ADTN	ADTRAN	ADTN Profile	ADTN Analysis
AAP	ADVANCE AUTO PARTS	AAP Profile	AAP Analysis
ADES	Advanced Emissions Solutions, Inc.	ADES Profile	ADES Analysis
AEIS	ADVANCED ENERGY INDUSTRIES	AEIS Profile	AEIS Analysis
AMD	ADVANCED MICRO DEVICES	AMD Profile	AMD Analysis
ADVS	ADVENT SOFTWARE	ADVS Profile	ADVS Analysis
ABCO	ADVISORY BOARD	ABCO Profile	ABCO Analysis
ACM	AECOM TECH	ACM Profile	ACM Analysis
AEGR	AEGERION PHARMACEUTICALS	AEGR Profile	AEGR Analysis
AEGN	AEGION	AEGN Profile	AEGN Analysis
AEPI	AEP INDUSTRIES	AEPI Profile	AEPI Analysis
AERI	Aerie Pharmaceuticals, Inc.	AERI Profile	AERI Analysis
ARX	AEROFLEX HOLDINGS	ARX Profile	ARX Analysis
ARO	AEROPOSTALE	ARO Profile	ARO Analysis
AVAV	AEROVIRONMENT	AVAV Profile	AVAV Analysis
AET	AETNA	AET Profile	AET Analysis
AMG	AFFILIATED MANAGERS GROUP	AMG Profile	AMG Analysis
AFFX	AFFYMETRIX	AFFX Profile	AFFX Analysis
AFL	AFLAC	AFL Profile	AFL Analysis
MITT	AG MTG INVESTMENT	MITT Profile	MITT Analysis
AGCO	AGCO	AGCO Profile	AGCO Analysis
AGEN	Agenus Inc.	AGEN Profile	AGEN Analysis
A	AGILENT TECHNOLOGIES	A Profile	A Analysis
AGYS	AGILYSYS	AGYS Profile	AGYS Analysis
AGIO	Agios Pharmaceuticals, Inc.	AGIO Profile	AGIO Analysis
ADC	AGREE REALTY	ADC Profile	ADC Analysis
AHC	AH BELO	AHC Profile	AHC Analysis
AL	AIR LEASE	AL Profile	AL Analysis
AIRM	AIR METHODS	AIRM Profile	AIRM Analysis
APD	AIR PRODUCTS & CHEMICALS	APD Profile	APD Analysis
ATSG	AIR TRANS SERVICES GROUP	ATSG Profile	ATSG Analysis
AYR	AIRCASTLE	AYR Profile	AYR Analysis
ARG	AIRGAS	ARG Profile	ARG Analysis
AKS	AK STEEL HOLDINGS	AKS Profile	AKS Analysis
AKAM	AKAMAI TECHNOLOGIES	AKAM Profile	AKAM Analysis
AKRX	AKORN	AKRX Profile	AKRX Analysis
ALG	ALAMO GROUP	ALG Profile	ALG Analysis
ALK	ALASKA AIR GROUP	ALK Profile	ALK Analysis
AIN	ALBANY INTL	AIN Profile	AIN Analysis
AMRI	ALBANY MOLECULAR RESEARCH	AMRI Profile	AMRI Analysis
ALB	ALBEMARLE	ALB Profile	ALB Analysis
AA	ALCOA	AA Profile	AA Analysis
ALR	ALERE	ALR Profile	ALR Analysis
ALEX	ALEXANDER & BALDWIN	ALEX Profile	ALEX Analysis
ALX	ALEXANDER'S	ALX Profile	ALX Analysis
ARE	ALEXANDRIA REAL ESTATE	ARE Profile	ARE Analysis
ALXN	ALEXION PHARMACEUTICALS	ALXN Profile	ALXN Analysis
ALCO	ALICO	ALCO Profile	ALCO Analysis
ALGN	ALIGN TECH	ALGN Profile	ALGN Analysis
ALIM	ALIMERA SCIENCES	ALIM Profile	ALIM Analysis
ALKS	ALKERMES	ALKS Profile	ALKS Analysis
Y	ALLEGHANY DEL	Y Profile	Y Analysis
ATI	ALLEGHENY TECHNOLOGIES	ATI Profile	ATI Analysis
ALGT	ALLEGIANT TRAVEL	ALGT Profile	ALGT Analysis
ALLE	Allegion plc Ordinary Shares	ALLE Profile	ALLE Analysis
AGN	ALLERGAN	AGN Profile	AGN Analysis
ALE	ALLETE	ALE Profile	ALE Analysis
ADS	ALLIANCE DATA SYSTEMS	ADS Profile	ADS Analysis
AFOP	Alliance Fiber Optic Products Inc.	AFOP Profile	AFOP Analysis
AIQ	ALLIANCE HEALTH CARE	AIQ Profile	AIQ Analysis
AOI	ALLIANCE ONE	AOI Profile	AOI Analysis
LNT	ALLIANT ENERGY	LNT Profile	LNT Analysis
ATK	ALLIANT TECHSYSTEMS	ATK Profile	ATK Analysis
ANV	ALLIED NEVADA GOLD CORP	ANV Profile	ANV Analysis
AWH	ALLIED WORLD ASSURANCE	AWH Profile	AWH Analysis
ALSN	ALLISON TRANSMISSION	ALSN Profile	ALSN Analysis
MDRX	ALLSCRIPTS-MISYS	MDRX Profile	MDRX Analysis
AFAM	ALMOST FAMILY	AFAM Profile	AFAM Analysis
ALNY	ALNYLAM PHARMACEUTICALS	ALNY Profile	ALNY Analysis
ALJ	ALON USA ENERGY	ALJ Profile	ALJ Analysis
AOSL	ALPHA & OMEGA	AOSL Profile	AOSL Analysis
ANR	ALPHA NATURAL RESOURCES	ANR Profile	ANR Analysis
ALTR	ALTERA	ALTR Profile	ALTR Analysis
AAMC	Altisource Asset Management Corporation	AAMC Profile	AAMC Analysis
ASPS	ALTISOURCE PORTFOLIO	ASPS Profile	ASPS Analysis
RESI	ALTISOURCE RESIDENTIAL CORP	RESI Profile	RESI Analysis
AIMC	ALTRA HOLDINGS	AIMC Profile	AIMC Analysis
MO	ALTRIA	MO Profile	MO Analysis
CAS	AM CASTLE	CAS Profile	CAS Analysis
AMAG	AMAG PHARMACEUTICALS	AMAG Profile	AMAG Analysis
AMZN	AMAZON.COM	AMZN Profile	AMZN Analysis
AMBC	Ambac Financial Group, Inc.	AMBC Profile	AMBC Analysis
AMBA	AMBARELLA INC	AMBA Profile	AMBA Analysis
AMC	AMC Entertainment Holdings, Inc.	AMC Profile	AMC Analysis
AMCX	AMC NETWORKS	AMCX Profile	AMCX Analysis
DOX	AMDOCS	DOX Profile	DOX Analysis
AMED	AMEDISYS	AMED Profile	AMED Analysis
UHAL	AMERCO	UHAL Profile	UHAL Analysis
AEE	AMEREN	AEE Profile	AEE Analysis
AMRC	AMERESCO	AMRC Profile	AMRC Analysis
ASEI	AMERICA SCIENCE & ENGINEERING	ASEI Profile	ASEI Analysis
AAL	American Airlines Group Inc.	AAL Profile	AAL Analysis
AAT	AMERICAN ASSETS TRUST	AAT Profile	AAT Analysis
AXL	AMERICAN AXLE & MFG HOLDINGS	AXL Profile	AXL Analysis
ACC	AMERICAN CAMPUS	ACC Profile	ACC Analysis
AGNC	AMERICAN CAPITAL AGENCY	AGNC Profile	AGNC Analysis
MTGE	AMERICAN CAPITAL MTG	MTGE Profile	MTGE Analysis
AEO	AMERICAN EAGLE	AEO Profile	AEO Analysis
AMZG	American Eagle Energy Corporation	AMZG Profile	AMZG Analysis
AEP	AMERICAN ELECTRIC POWER	AEP Profile	AEP Analysis
AEL	AMERICAN EQUITY INVEST	AEL Profile	AEL Analysis
AXP	AMERICAN EXPRESS	AXP Profile	AXP Analysis
AFG	AMERICAN FINANCIAL GROUP	AFG Profile	AFG Analysis
AIG	AMERICAN INTL	AIG Profile	AIG Analysis
NOW	AMERICAN INTL GROUP MARKET IND	NOW Profile	NOW Analysis
AMNB	AMERICAN NATIONAL	AMNB Profile	AMNB Analysis
ANAT	AMERICAN NATIONAL INSURANCE	ANAT Profile	ANAT Analysis
APEI	AMERICAN PUBLIC EDUCATION	APEI Profile	APEI Analysis
ARII	AMERICAN RAILCAR	ARII Profile	ARII Analysis
ARCP	AMERICAN REALTY CAPITAL	ARCP Profile	ARCP Analysis
ARC	AMERICAN REPROGRAPHICS	ARC Profile	ARC Analysis
ARPI	American Residential Properties, Inc.	ARPI Profile	ARPI Analysis
AMSWA	AMERICAN SOFTWARE	AMSWA Profile	AMSWA Analysis
AWR	AMERICAN STATES WATER	AWR Profile	AWR Analysis
AMT	AMERICAN TOWER	AMT Profile	AMT Analysis
AVD	AMERICAN VANGUARD	AVD Profile	AVD Analysis
AWK	AMERICAN WATER WORKS	AWK Profile	AWK Analysis
AMWD	AMERICAN WOODMARK	AMWD Profile	AMWD Analysis
CRMT	AMERICAS CAR-MART	CRMT Profile	CRMT Analysis
AMP	AMERIPRISE FINANCIAL	AMP Profile	AMP Analysis
ABCB	AMERIS BANCORP	ABCB Profile	ABCB Analysis
AMSF	AMERISAFE	AMSF Profile	AMSF Analysis
ABC	AMERISOURCEBERGEN	ABC Profile	ABC Analysis
AMH	AMERUS GROUP CO	AMH Profile	AMH Analysis
ATLO	Ames National Corporation	ATLO Profile	ATLO Analysis
AME	AMETEK	AME Profile	AME Analysis
AMGN	AMGEN	AMGN Profile	AMGN Analysis
AMKR	AMKOR TECH	AMKR Profile	AMKR Analysis
AHS	AMN HEALTH CARE SERVICES	AHS Profile	AHS Analysis
AP	AMPCO-PITTSBURGH	AP Profile	AP Analysis
APH	AMPHENOL	APH Profile	APH Analysis
AMPE	AMPIO PHARMACEUTICALS	AMPE Profile	AMPE Analysis
AMRE	AMREIT	AMRE Profile	AMRE Analysis
AMSG	AMSURG	AMSG Profile	AMSG Analysis
AFSI	AMTRUST FINANCIAL SERVICES	AFSI Profile	AFSI Analysis
AMRS	AMYRIS	AMRS Profile	AMRS Analysis
ANAC	ANACOR PHARMACEUTICALS	ANAC Profile	ANAC Analysis
APC	ANADARKO PETROLEUM	APC Profile	APC Analysis
ADI	ANALOG DEVICES	ADI Profile	ADI Analysis
ALOG	ANALOGIC	ALOG Profile	ALOG Analysis
ANDE	ANDERSONS	ANDE Profile	ANDE Analysis
ANGI	ANGIES LIST	ANGI Profile	ANGI Analysis
ANGO	ANGIODYNAMICS	ANGO Profile	ANGO Analysis
ANIP	ANI Pharmaceuticals, Inc.	ANIP Profile	ANIP Analysis
ANIK	ANIKA THERAPEUTICS	ANIK Profile	ANIK Analysis
AXE	ANIXTER INTL	AXE Profile	AXE Analysis
ANN	ANN	ANN Profile	ANN Analysis
NLY	ANNALY CAPITAL	NLY Profile	NLY Analysis
BNNY	ANNIE'S	BNNY Profile	BNNY Analysis
ANSS	ANSYS	ANSS Profile	ANSS Analysis
ATRS	Antares Pharma Inc.	ATRS Profile	ATRS Analysis
AR	Antero Resources Corporation	AR Profile	AR Analysis
ANH	ANWORTH MTG ASSET	ANH Profile	ANH Analysis
AOS	AO SMITH	AOS Profile	AOS Analysis
AOL	AOL	AOL Profile	AOL Analysis
AON	AON	AON Profile	AON Analysis
APA	APACHE	APA Profile	APA Analysis
AIV	APARTMENT INVESTMENT	AIV Profile	AIV Analysis
APAGF	Apco Oil & Gas International Inc.	APAGF Profile	APAGF Analysis
APOG	APOGEE ENTERPRISES	APOG Profile	APOG Analysis
ARI	APOLLO COMMERCIAL	ARI Profile	ARI Analysis
APOL	APOLLO GROUP	APOL Profile	APOL Analysis
AMTG	APOLLO RESIDENTIAL	AMTG Profile	AMTG Analysis
AAPL	APPLE	AAPL Profile	AAPL Analysis
AIT	APPLIED INDUSTRIAL	AIT Profile	AIT Analysis
AMAT	APPLIED MATERIALS	AMAT Profile	AMAT Analysis
AMCC	APPLIED MICRO CIRCUITS	AMCC Profile	AMCC Analysis
AAOI	Applied Optoelectronics, Inc.	AAOI Profile	AAOI Analysis
AREX	APPROACH RESOURCES	AREX Profile	AREX Analysis
ATR	APTARGROUP	ATR Profile	ATR Analysis
WTR	AQUA AMERICA	WTR Profile	WTR Analysis
ARMK	ARAMARK Holdings Corporation	ARMK Profile	ARMK Analysis
PETX	Aratana Therapeutics, Inc.	PETX Profile	PETX Analysis
ARCW	ARC Group Worldwide, Inc.	ARCW Profile	ARCW Analysis
ACGL	ARCH CAPITAL GROUP	ACGL Profile	ACGL Analysis
ACI	ARCH COAL	ACI Profile	ACI Analysis
ADM	ARCHER-DANIELS MIDLAND	ADM Profile	ADM Analysis
ACAT	ARCTIC CAT	ACAT Profile	ACAT Analysis
ARNA	ARENA PHARMACEUTICALS	ARNA Profile	ARNA Analysis
ACRE	ARES COMMERCIAL REAL	ACRE Profile	ACRE Analysis
AGX	ARGAN	AGX Profile	AGX Analysis
AGII	ARGO GROUP INTL	AGII Profile	AGII Analysis
ARIA	ARIAD PHARMACEUTICALS	ARIA Profile	ARIA Analysis
AI	ARLINGTON ASSET INVESTMENT	AI Profile	AI Analysis
ARR	ARMOUR RESIDENTIAL REIT	ARR Profile	ARR Analysis
AWI	ARMSTRONG WORLD INDSTRIES	AWI Profile	AWI Analysis
ARRY	ARRAY BIOPHARMA	ARRY Profile	ARRY Analysis
ARRS	ARRIS GROUP	ARRS Profile	ARRS Analysis
ARW	ARROW ELECTRONICS	ARW Profile	ARW Analysis
AROW	ARROW FINANCIAL	AROW Profile	AROW Analysis
ARWR	Arrowhead Research Corp.	ARWR Profile	ARWR Analysis
AJG	ARTHUR J GALLAGHER	AJG Profile	AJG Analysis
APAM	Artisan Partners Asset Management Inc.	APAM Profile	APAM Analysis
ARTNA	ARTISAN RESOURCE	ARTNA Profile	ARTNA Analysis
ARUN	ARUBA NETWORKS	ARUN Profile	ARUN Analysis
ABG	ASBURY AUTOMOTIVE GROUP	ABG Profile	ABG Analysis
ASNA	ASCENA RETAIL GROUP	ASNA Profile	ASNA Analysis
ASCMA	ASCENT CAPITAL GROUP	ASCMA Profile	ASCMA Analysis
AHP	Ashford Hospitality Prime, Inc.	AHP Profile	AHP Analysis
AHT	ASHFORD HOSPITALITY TRUST	AHT Profile	AHT Analysis
ASH	ASHLAND	ASH Profile	ASH Analysis
AHL	ASPEN INSURANCE HOLDINGS	AHL Profile	AHL Analysis
AZPN	ASPEN TECH	AZPN Profile	AZPN Analysis
ASBC	ASSOCIATED BANC-CORP	ASBC Profile	ASBC Analysis
AEC	ASSOCIATED ESTATES REALTY	AEC Profile	AEC Analysis
AIZ	ASSURANT	AIZ Profile	AIZ Analysis
AGO	ASSURED GUARANTY	AGO Profile	AGO Analysis






WORKDAY INC WDAYWORLD ACCEPTANCE CORP WRLDWORLD FUEL SVCS CORP INTWORLD WRESTLING ENTMNT WWEWORTHINGTON INDUSTRIES WORWPX ENERGY INC   WPXWRIGHT MEDICAL GROUP IN WMGIWSFS FINANCIAL CORP WSFSWYNDHAM WORLDWIDE CORP WYNWYNN RESORTS LTD WYNNXCEL ENERGY INC   XELXCERRA CORPORATION XCRAXENCOR INC   XNCRXENOPORT INC   XNPTXERIUM TECHNOLOGIES INC XRMXEROX CORP   XRXXILINX INC   XLNXXL GROUP PLC   XLXO GROUP INC   XOXOXOMA CORPORATION XOMAXOOM CORPORATION XOOMXPO LOGISTICS INC   XPOYADKIN FINANCIAL CORP YDKNYAHOO INC   YHOOYELP INC   YELPYORK WATER COMPANY YORWYRC WORLDWIDE INC YRCWYUM! BRANDS INC   YUMYUME INC   YUMEZEBRA TECHNOLOGIES CORP ZBRAZELTIQ AESTHETICS INC ZLTQZENDESK INC   ZENZEP INC   ZEPZILLOW INC   ZZIMMER HOLDINGS INC ZMHZIONS BANCORPORATION ZIONZIOPHARM ONCOLOGY INC ZIOPZIX CORP   ZIXIZOES KITCHEN INC ZOESZOETIS INC ZTSZOGENIX INC ZGNXZULILY INC ZUZUMIEZ INC ZUMZZYNGA INC ZNGAXYLEM INC XYL